#########
#.......#
#.o..#x##
#.#.o...#
#..@..x.#
#########